; ---------------------------------------------------------
; Hunspell tags
; ---------------------------------------------------------

__flags__
Nom/adjectif simple ou épicène
S.() = Pluriel en s
S*() = Pluriel en s, élisions
X.() = Pluriel en x
X*() = Pluriel en x, élisions

Nom/adjectif non épicène
F.() = Pluriel en s
F*() = Pluriel en s, élisions
W.() = Pluriel en x
W*() = Pluriel en x, élisions

Divers
L'D'Q' = Élisions pour mot invariable
A.() = Pluriel des mots anglais
A*() = Pluriel des mots anglais, élisions
I.() = Pluriel des mots latins/italiens
I*() = Pluriel des mots latins/italiens, élisions

Élisions
D'Q' = Adverbe
L'D'Q' = Prénom, Ville
L'D' = Pays
L' = Région

Verbe du 1er groupe (exemples)
a0p+() = Pas d’élisions, part. passé variable
a0p.() = Pas d’élisions, part. passé invariable
a1p.() = Intransitif (élisions)
a2p+() = Transitif (élisions)
a3p+() = Pronominal (élisions)
a4p+() = Transitif et pronominal (élisions)
a5p.() = Transitif indirect (élisions)

Verbes du 2e groupe (exemples)
f0p+() = Pas d’élisions, part. passé variable
f0p.() = Pas d’élisions, part. passé invariable
f1p.() = Intransitif (élisions)
f2p+() = Transitif (élisions)
f3p+() = Pronominal (élisions)
f4p+() = Transitif et pronominal (élisions)
f5p.() = Transitif indirect (élisions)

__po__
Substantif
nom = Nom
adj = Adjectif
nom adj = Nom et adjectif
Verbe
v1 = Verbe du premier groupe
v2 = Verbe du deuxième groupe
Complément
adv = Adverbe
loc.adv = Locution adverbiale
loc.adj = Locution adjectivale
Nom propre
prn = Prénom
patr = Patronyme
geo = Ville, pays, montagne, île, fleuve, mer, etc.
Autres
interj = Interjection
mg = Mot grammatical
det = Déterminant
prep = Préposition
nb = Nombre
cj = Conjonction
pro = Pronom

__is__
Épicène
epi = Épicène
epi sg = Épicène singulier
epi pl = Épicène pluriel
epi inv = Épicène invariable
Masculin
mas = Masculin
mas sg = Masculin singulier
mas pl = Masculin pluriel
mas inv = Masculin invariable
Féminin
fem = Féminin
fem sg = Féminin singulier
fem pl = Féminin pluriel
fem inv = Féminin invariable

__ds__

__ts__

__ip__

__dp__

__tp__

__sp__

__pa__


; ---------------------------------------------------------
; Dicollecte tags
; ---------------------------------------------------------

; Champs lexicaux
__lex__
Variantes orthographiques
var = Variante orthographique proche
alt = Graphie alternative éloignée
dic = répertoriée par un dictionnaire de référence

Usage
rare = Rare (< 2000 occur. sur Google fr)
vieux = Vieux, désuet, inusité
néo = Néologisme
fam = Familier
péj = Péjoratif
fxa = Faux-ami

Catégorie
symb = Symbole
abr = Abréviation
abty = Abréviation typographique
cité = Ville, village, quartier
col = Coloris
dép = Nom déposé
TM = Produit, compagnie
hist = Figure historique
onom = Onomatopée

Variétés nationales/régionales
afr = Africanisme
belg = Belgicisme
fra = Francisme
helv = Helvétisme
québ = Québécisme
rég = Régionalisme

Langues régionales
occ = Occitan, provençal, auvergnat, gascon, etc.
oil = Langue d’oïl, normand, champenois, lorrain, wallon, etc.
celt = Celte, gaulois, gaélique, brittonique, breton, etc.

Origine étrangère
lat = Latin
grec = Grec
angl = Anglais
all = Allemand
néer = Néerlandais
fla = Flamand
ita = Italien
esp = Espagnol
port = Portugais
dan = Danois
norv = Norvégien
sué = Suédois
finn = Finnois
isl = Islandais
rus = Russe
ukr = Ukrainien
pol = Polonais
turc = Turc
pers = Persan
ara = Arabe
héb = Hébreu
hind = Hindi
sskr = Sanskrit
chin = Chinois
jap = Japonais
amér = Américain (natifs)
étr = Autre origine étrangère

; Champs sémantiques
__sem__
Nature
bot = Botanique
minér = Minéralogie
myco = Mycologie
zool = Zoologie

Divers
lang = Langue
hist = Histoire

Sciences
astron = Astronomie
bio = Biologie
bioch = Biochimie
chim = Chimie
cristal = Cristallographie
géogr = Géographie
géol = Géologie
log = Logique
math = Mathématiques
paléo = Paléontologie
phys = Physique
sc = Sciences

Médecine
anat = Anatomie
bact = Bactériologie
chir = Chirurgie
méd = Médecine
neuro = Neurologie
patho = Pathologie
pharma = Pharmaceutique
physio = Physiologie

Pensée
anthr = Anthropologie
démogr = Démographie
écolo = Écologie
écono = Économie
éthno = Ethnologie
étho = Éthologie
épis = Épistémologie
lingu = Linguistique
philo = Philosophie
phonét = Phonétique
psycho = Psychologie
psychan = Psychanalyse
psychia = Psychiatrie
socio = Sociologie

Mysticisme
alch = Alchimie
astrol = Astrologie
chris = Christianisme
éso = Ésotérisme
islam = Islam
jud = Judaïsme
myth = Mythologie
reli = Religion

Techniques
aéron = Aéronautique
astronaut = Astronautique
arm = Armurerie
didac = Didactique
électro = Électronique
hitech = Haute technologie (Hi-tech)
impr = Imprimerie
info = Informatique
ingé = Ingénierie
logis = Logistique
méca = Mécanique
métal = Métallurgie
techni = Technique

Blabla
admin = Administration
comm = Communication
march = Commerce
droit = Droit
polit = Politique
pub = Publicité

Métiers
agri = Agriculture
arbo = Arboriculture
archi = Architecture
bât = Bâtiment
charp = Charpenterie
constr = Construction
ébén = Ébénisterie
maçon = Maçonnerie
marin = Marine
milit = Militaire
pêche = Pêche
sylvi = Sylviculture
urba = Urbanisme

Argent
compta = Comptabilité
fin = Finances
fisc = Fiscalité

Arts
art = Arts
calli = Calligraphie
chant = Chant
ciné = Cinéma
danse = Danse
litt = Littérature
mus = Musique
peint = Peinture
photo = Photographie
poés = Poésie
sculp = Sculpture
théâ = Théâtre

Passe-temps
alcool = Alcool
chass = Chasse
cuis = Cuisine
hérald = Héraldique
jard = Jardinage
jeu = Jeux
numis = Numismatique
sport = Sport


; ---------------------------------------------------------
; Synsets tags
; ---------------------------------------------------------
__sspos__
nom = Nom
adj = Adjectif
nom adj = Nom et adjectif
verb = Verbe
adv = Adverbe
loc.adv = Locution adverbiale

__sstags__
fam = Familier